######
#  @ #
# $  #
#   .#
#    #
######
