######
#    #
#    #
# .$ #
# @  #
######
