######
#    #
#  . #
#  $ #
# @  #
######
