######
# @  #
# $  #
#    #
# .  #
######
