######
#    #
#    #
# $ .#
#@#  #
######
