######
#    #
#  .@#
# $  #
#    #
######
