######
#   @#
# $  #
#.   #
#    #
######
