######
#  # #
#  $ #
#.   #
# @  #
######
