######
#    #
# @$ #
#    #
#   .#
######
