######
#  @ #
#.$  #
#    #
#    #
######
